####################
#..................#
#..................#
#..................#
#..................#
#..................#
#.....#..####......#
#.....#.....#......#
#.....#.....#......#
#.....#######......#
#..................#
#..................#
##########.........#
#.......##.........#
#.......##.........#
#.......##.........#
#..................#
#..................#
#..................#
####################